Test
00000000000000000000000000000000
00000000000000000000000000000000
00000000000000000000000000000000
00000000000000000000000000000000
00000000000000000000000000000000
000009aaa0000000000009aaa0000000
00000aaaa000000000000aaaa0000000
00000aaaa000000000000aaaa0000000
00000000000000000000000000000000
00000000000000000000000000000000
00000000000000000000000000000000
00000000000000000000000000000000
00000000000000000000000000000000
00000000000000000000000000000000
00000000000000000000000000000000
44444444444424434424444444444444
00000000000020030020000000000000
00007000000020030020000070000000
00000000000020030020000000000000
00000000100020030020000100000000
00000000000020030020000000000000
