Level 1ss
00000000000000000000000000000000
00009aaa000000000000000000000000
0000aaaa000000000000000000000000
0000aaaa000000000000000000000000
000000000000000000026b6b6b6b0000
00000000000000000002000000020000
00000000000000000002000000020000
00000000000000000002000000020000
55555555553333333333333333323333
00000000000000000000000000020000
00000000000000000000000000020000
00000000000000000000008a00020000
0000000000000000000000aa00020000
00000000000000000000000000020000
00000000000000000000000000020000
33444444332336bbbbbbb33333333333
00000000002000000000000000000000
00000000002000000007000007000070
00000000002000000000000000000000
00001000002000000000000000000000
00000000002000000000000000000000
 Ladder test
00000000000000000000000000000000
00000000000000000000000000000000
00000000000000000000000000000000
00000000000000000000000000000000
00000000000000000000000000000000
00000000000000000000000000000000
00000000000000000000000000000000
00000000000000000000000000000000
00000000000000200000000000000000
00000000000333233333323300000000
00000000000000200000020000000000
00000000000000200000020000000000
00000000000000200000020000000000
00000000000000200000020000000000
00000000000020200000020000000000
00000000003323330000020000033333
00000000000020000000020000030000
00000000000020000000020000030000
00000000000020000000020000030000
00000100000020000000020000030070
00000000000020000000020000030000
